2 map_2.txt
>
---!----
!!!!!!!!
--A-----
----!---
T-2-----
---A--A-
---!--!-
--------
