1 map_1.txt
2 map_1.txt
>
--A---1-
--------
--------
--------
-----2--
--------
--------
-------T

