2 map_2.txt
>
---S----
--------
--A-----
----S---
T-2-----
---A--A-
---S--!-
--------
