000E0000
00000000
00000000
0000E000
T0000000
K0000000
000E00E0
00000000
