---!----
--------
--A-----
----!---
T-------
---A--A-
---!--!-
--------
